###########################
#JMM####MMMMMMMMBMM####MMC#
#M#MMMMMM####D####MMMMMM#M#
#M#####M###BMMMM#####M###M#
#MMMOMMMMMDM#C#MDMMMMMMMMO#
#######D###M###M#M####A####
#MMOMMMMMMDM#C#MDMMMMMMOMM#
#A####MM#M#MMMMM#M#D#####D#
#MMMMM#M#M#######M#MMMMMMM#
##C##M#MBMMMMDMMMM#M#M##C##
###########################

